,Players,Prev4's,Prev5's,Prev6's,Cur4's,Cur5's,Cur6's,Inc4's,Inc5's,Inc6's,4@1point,5@5point,6@5point,total
72,milleeee,0,41,3,0,140,5,0,99,2,0,495,10,505
0,MorganKell,0,1723,271,0,1812,281,0,89,10,0,445,50,495
16,brokenjade,2,2152,141,2,2211,145,0,59,4,0,295,20,315
25,MaceWindujr,1277,1798,94,1277,1852,94,0,54,0,0,270,0,270
61,Karlosas,0,1917,7,0,1967,8,0,50,1,0,250,5,255
64,KecIsHere,0,0,0,0,38,8,0,38,8,0,190,40,230
78,viktorija,0,31,1,0,74,3,0,43,2,0,215,10,225
8,Theomore,0,1192,183,0,1232,187,0,40,4,0,200,20,220
4,Guts Black,2852,1696,223,2852,1732,230,0,36,7,0,180,35,215
62,R1m,0,1586,7,0,1627,8,0,41,1,0,205,5,210
76,Huuloc,0,97,2,0,137,4,0,40,2,0,200,10,210
24,xLestat,0,1042,100,0,1081,100,0,39,0,0,195,0,195
14,SlackOfDoom,45,1357,146,45,1388,153,0,31,7,0,155,35,190
28,17Palad1nOnm,2,1238,69,2,1270,74,0,32,5,0,160,25,185
75,tiddabeth,0,754,4,0,791,4,0,37,0,0,185,0,185
53,Daessa,0,390,22,0,426,22,0,36,0,0,180,0,180
66,Dimsa,0,26,3,0,58,7,0,32,4,0,160,20,180
3,EDOX,1631,1833,229,1631,1865,232,0,32,3,0,160,15,175
41,SireMuch,4,173,34,4,203,38,0,30,4,0,150,20,170
12,StankoSRBLFC,1851,1394,157,1851,1427,158,0,33,1,0,165,5,170
1,King Rale,176,2312,273,176,2339,278,0,27,5,0,135,25,160
80,DKH,1,1115,1,1,1145,2,0,30,1,0,150,5,155
81,Eragon67,1,751,2,1,782,2,0,31,0,0,155,0,155
5,ArT,0,813,202,0,839,207,0,26,5,0,130,25,155
57,komyc,2743,1488,11,2743,1517,12,0,29,1,0,145,5,150
91,Lord Frost,0,10,0,0,40,0,0,30,0,0,150,0,150
71,Kaelthas27,3,619,5,3,649,5,0,30,0,0,150,0,150
58,buddha6366,845,1237,12,845,1267,12,0,30,0,0,150,0,150
15,Jaredsc,0,1029,144,0,1057,146,0,28,2,0,140,10,150
67,MORTI,196,1823,5,196,1851,6,0,28,1,0,140,5,145
38,HussyofWhips,0,156,38,0,176,47,0,20,9,0,100,45,145
35,S4TN4AM1R,0,257,48,0,279,54,0,22,6,0,110,30,140
51,Brooster,0,641,23,0,667,25,0,26,2,0,130,10,140
73,SFuRak,5836,1534,4,5836,1562,4,0,28,0,0,140,0,140
49,Wntrking,0,194,26,0,220,28,0,26,2,0,130,10,140
22,Dasharath,4896,1110,103,4896,1133,107,0,23,4,0,115,20,135
7,dingleberry,0,942,188,0,964,193,0,22,5,0,110,25,135
48,pembaa,0,527,25,0,551,28,0,24,3,0,120,15,135
47,didialfeim,0,939,28,0,964,30,0,25,2,0,125,10,135
55,EnchantressM,0,1394,18,0,1421,18,0,27,0,0,135,0,135
42,Traksimus,0,161,32,0,181,38,0,20,6,0,100,30,130
74,MariaZoe,1,1198,4,1,1224,4,0,26,0,0,130,0,130
27,SEARCHER,1525,1608,80,1525,1629,85,0,21,5,0,105,25,130
9,JohnHawkwood,2018,1934,181,2018,1956,185,0,22,4,0,110,20,130
13,Wareblade,0,611,152,0,630,158,0,19,6,0,95,30,125
32,RMonn,0,617,56,0,638,60,0,21,4,0,105,20,125
84,DownBerry,2,885,1,2,910,1,0,25,0,0,125,0,125
19,Klaus Schnee,0,1041,121,0,1062,125,0,21,4,0,105,20,125
77,arcane,0,1020,3,0,1045,3,0,25,0,0,125,0,125
10,BuharaShroom,12,928,167,12,949,170,0,21,3,0,105,15,120
26,Maverick,0,548,88,0,566,94,0,18,6,0,90,30,120
29,SashaM,799,1994,73,799,2018,73,0,24,0,0,120,0,120
20,Duke Martin,2095,1264,119,2095,1285,122,0,21,3,0,105,15,120
33,Draakir,0,609,56,0,629,60,0,20,4,0,100,20,120
79,Lord Lesa,0,25,2,0,48,3,0,23,1,0,115,5,120
90,Lilith Lilit,0,21,0,2,44,0,2,23,0,2,115,0,117
36,FreyaMaiden,0,585,47,0,605,50,0,20,3,0,100,15,115
86,Qkate,0,227,1,0,250,1,0,23,0,0,115,0,115
88,Foxxy,3265,1396,0,3265,1419,0,0,23,0,0,115,0,115
39,trevers,0,243,42,0,264,44,0,21,2,0,105,10,115
70,ZENZEY,0,1024,5,0,1047,5,0,23,0,0,115,0,115
94,Sandra Lady,0,14,0,0,37,0,0,23,0,0,115,0,115
23,Gunnarr716,0,956,101,0,975,105,0,19,4,0,95,20,115
34,Odr,2,458,56,3,477,59,1,19,3,1,95,15,111
6,pikabooooo,954,790,196,954,808,200,0,18,4,0,90,20,110
18,koddi,6,1021,125,6,1038,130,0,17,5,0,85,25,110
89,SERHAT STARK,0,274,0,0,296,0,0,22,0,0,110,0,110
96,BOrke,0,0,0,0,22,0,0,22,0,0,110,0,110
11,mirjan,11,736,159,11,754,163,0,18,4,0,90,20,110
37,TripleP,2,795,41,2,811,47,0,16,6,0,80,30,110
68,Sir Mogque,0,948,6,0,970,6,0,22,0,0,110,0,110
69,Csapek,0,948,6,0,970,6,0,22,0,0,110,0,110
59,malimiki,3449,991,11,3449,1012,11,0,21,0,0,105,0,105
65,Thos,2,787,7,2,808,7,0,21,0,0,105,0,105
2,Lord Gitter,1251,1152,254,1251,1172,255,0,20,1,0,100,5,105
40,Fyre,0,192,38,0,211,40,0,19,2,0,95,10,105
43,GEERT,868,1289,36,868,1310,36,0,21,0,0,105,0,105
44,Freyyr,0,533,35,0,554,35,0,21,0,0,105,0,105
45,LalaTheWhite,0,210,25,0,225,31,0,15,6,0,75,30,105
83,sakis111,0,310,2,0,331,2,0,21,0,0,105,0,105
60,Milos Iva,0,11,4,0,26,10,0,15,6,0,75,30,105
46,Lord Anibal,21,990,30,21,1011,30,0,21,0,0,105,0,105
30,12M,1422,1007,71,1422,1028,71,0,21,0,0,105,0,105
54,Beha,0,214,21,0,235,21,0,21,0,0,105,0,105
56,Skipka,0,300,13,0,321,13,0,21,0,0,105,0,105
17,Kingsy D,3473,1262,127,3473,1280,130,0,18,3,0,90,15,105
31,Blackrainbow,5,878,65,5,895,69,0,17,4,0,85,20,105
50,vampirewolfG,1,991,24,1,1010,25,0,19,1,0,95,5,100
85,UhtredR,2,890,1,2,910,1,0,20,0,0,100,0,100
52,Boss X,51,767,23,51,786,24,0,19,1,0,95,5,100
63,docente,1192,1235,8,1192,1255,8,0,20,0,0,100,0,100
93,zui,0,17,0,0,37,0,0,20,0,0,100,0,100
92,KEVA MILEVA,0,19,0,0,38,0,0,19,0,0,95,0,95
87,ANASTASIAs,0,0,0,0,15,1,0,15,1,0,75,5,80
95,Red Star SRB,0,9,0,0,23,0,0,14,0,0,70,0,70
21,xstanfordx,0,1653,105,0,1664,108,0,11,3,0,55,15,70
82,Mindaugyno,2,469,2,2,480,2,0,11,0,0,55,0,55
97,jokke,0,10,0,0,21,0,0,11,0,0,55,0,55
